1111111111
1000000001
10C0000001
10P0000001
10E0000001
1111111111
