1111111111
100P000001
1111111111
1000000001
10E000C001
1111111111
