111111111111111111111111111111111111
100P00000000000000000000000000000001
100000000000000000000000000000000001
100000000000000000000000000000000001
100000000000000000000000000000000001
100000000000000000000000000000000001
100000000000000000000000000000000001
10E000C00000000000000000000000000001
111111111111111111111111111111111111
